11111111111111111111111111111111
10000000000000000000000000000001
10000000000000000000000000000001
10000000000000000000000000000001
10001111000000000000000011110001
10001000000000000000000000010001
10001000000000000000000000010001
10001000000000000000000000010001
10000000000000000000000000000001
10000000000000000000000000000001
10000000000000000000000000000001
10000000000000000000000000000001
10000000000000000000000000000001
10000000000000000000000000000001
10000000000000000000000000000001
10000000000000000000020000000001
10001000000000000000000000010001
10001000000000000000000000010001
10001000000000000000000000010001
10001111000000000000000011110001
10000000000000000000000000000001
10000000000000000000000000000001
10000000000000000000000000000001
11111111111111111111111111111111